"filename", "language", "Markdown", "JSON", "Dart", "YAML", "comment", "blank", "total"
"/Users/carltonaikins/Desktop/Home/Programming/projects/elisha/.vscodecounter/2021-08-12_21-48-15/details.md", "Markdown", -131, 0, 0, 0, 0, -6, -137
"/Users/carltonaikins/Desktop/Home/Programming/projects/elisha/.vscodecounter/2021-08-12_21-48-15/results.md", "Markdown", -78, 0, 0, 0, 0, -7, -85
"/Users/carltonaikins/Desktop/Home/Programming/projects/elisha/.vscodecounter/2022-02-01_00-26-37/details.md", "Markdown", 162, 0, 0, 0, 0, 6, 168
"/Users/carltonaikins/Desktop/Home/Programming/projects/elisha/.vscodecounter/2022-02-01_00-26-37/diff-details.md", "Markdown", 61, 0, 0, 0, 0, 6, 67
"/Users/carltonaikins/Desktop/Home/Programming/projects/elisha/.vscodecounter/2022-02-01_00-26-37/diff.md", "Markdown", 44, 0, 0, 0, 0, 7, 51
"/Users/carltonaikins/Desktop/Home/Programming/projects/elisha/.vscodecounter/2022-02-01_00-26-37/results.json", "JSON", 0, 1, 0, 0, 0, 0, 1
"/Users/carltonaikins/Desktop/Home/Programming/projects/elisha/.vscodecounter/2022-02-01_00-26-37/results.md", "Markdown", 88, 0, 0, 0, 0, 7, 95
"/Users/carltonaikins/Desktop/Home/Programming/projects/elisha/README.md", "Markdown", 29, 0, 0, 0, 1, 6, 36
"/Users/carltonaikins/Desktop/Home/Programming/projects/elisha/lib/src/config/bottom_navigation_bar.dart", "Dart", 0, 0, 1, 0, 0, 0, 1
"/Users/carltonaikins/Desktop/Home/Programming/projects/elisha/lib/src/providers/bible_translations_provider.dart", "Dart", 0, 0, -1, 0, 0, -1, -2
"/Users/carltonaikins/Desktop/Home/Programming/projects/elisha/lib/src/providers/daily_devotional_service_provider.dart", "Dart", 0, 0, 1, 0, 0, 1, 2
"/Users/carltonaikins/Desktop/Home/Programming/projects/elisha/lib/src/providers/daily_readings_future_provider.dart", "Dart", 0, 0, 0, 0, 0, 1, 1
"/Users/carltonaikins/Desktop/Home/Programming/projects/elisha/lib/src/providers/last_translation_book_chapter_provider.dart", "Dart", 0, 0, -1, 0, 0, 0, -1
"/Users/carltonaikins/Desktop/Home/Programming/projects/elisha/lib/src/providers/verse_of_the_day_future_provider.dart", "Dart", 0, 0, 0, 0, 0, 1, 1
"/Users/carltonaikins/Desktop/Home/Programming/projects/elisha/lib/src/providers/youtube_fetch_channel_future_provider.dart", "Dart", 0, 0, 1, 0, 0, 1, 2
"/Users/carltonaikins/Desktop/Home/Programming/projects/elisha/lib/src/repositories/bible_repository.dart", "Dart", 0, 0, -2, 0, 0, 0, -2
"/Users/carltonaikins/Desktop/Home/Programming/projects/elisha/lib/src/repositories/daily_readings_repository.dart", "Dart", 0, 0, -1, 0, -17, -2, -20
"/Users/carltonaikins/Desktop/Home/Programming/projects/elisha/lib/src/services/bible_service.dart", "Dart", 0, 0, -1, 0, -5, -3, -9
"/Users/carltonaikins/Desktop/Home/Programming/projects/elisha/lib/src/ui/components/daily_devotional_card.dart", "Dart", 0, 0, -4, 0, 0, 0, -4
"/Users/carltonaikins/Desktop/Home/Programming/projects/elisha/lib/src/ui/components/error_card.dart", "Dart", 0, 0, 1, 0, 0, 0, 1
"/Users/carltonaikins/Desktop/Home/Programming/projects/elisha/lib/src/ui/components/loading_card.dart", "Dart", 0, 0, 1, 0, 0, 0, 1
"/Users/carltonaikins/Desktop/Home/Programming/projects/elisha/lib/src/ui/components/show_favorite_verse_bottom_sheet.dart", "Dart", 0, 0, 1, 0, 0, 0, 1
"/Users/carltonaikins/Desktop/Home/Programming/projects/elisha/lib/src/ui/components/something_went_wrong.dart", "Dart", 0, 0, 1, 0, 0, 0, 1
"/Users/carltonaikins/Desktop/Home/Programming/projects/elisha/lib/src/ui/components/streaks_card.dart", "Dart", 0, 0, -4, 0, 0, 0, -4
"/Users/carltonaikins/Desktop/Home/Programming/projects/elisha/lib/src/ui/components/terms_and_privacy_policy_text.dart", "Dart", 0, 0, 1, 0, 0, 0, 1
"/Users/carltonaikins/Desktop/Home/Programming/projects/elisha/lib/src/ui/components/verse_of_the_day_card.dart", "Dart", 0, 0, -8, 0, 0, 0, -8
"/Users/carltonaikins/Desktop/Home/Programming/projects/elisha/lib/src/ui/views/bible_view/bible_view.dart", "Dart", 0, 0, 65, 0, 0, 5, 70
"/Users/carltonaikins/Desktop/Home/Programming/projects/elisha/lib/src/ui/views/bible_view/components/show_translations_bottom_sheet.dart", "Dart", 0, 0, 3, 0, 0, 0, 3
"/Users/carltonaikins/Desktop/Home/Programming/projects/elisha/lib/src/ui/views/bible_view/components/translation_card.dart", "Dart", 0, 0, 3, 0, 2, 1, 6
"/Users/carltonaikins/Desktop/Home/Programming/projects/elisha/lib/src/ui/views/bookmarked_chapter_view/bookmarked_chapter_view.dart", "Dart", 0, 0, -5, 0, 0, 0, -5
"/Users/carltonaikins/Desktop/Home/Programming/projects/elisha/lib/src/ui/views/bookmarked_chapter_view/components/bookmarked_chapter_view_header.dart", "Dart", 0, 0, 1, 0, 0, 0, 1
"/Users/carltonaikins/Desktop/Home/Programming/projects/elisha/lib/src/ui/views/bookmarked_chapters_view/bookmarked_chapters_view.dart", "Dart", 0, 0, -4, 0, 0, 0, -4
"/Users/carltonaikins/Desktop/Home/Programming/projects/elisha/lib/src/ui/views/bookmarked_chapters_view/components/bookmarked_chapter_card.dart", "Dart", 0, 0, -3, 0, 0, 0, -3
"/Users/carltonaikins/Desktop/Home/Programming/projects/elisha/lib/src/ui/views/bookmarked_chapters_view/components/bookmarked_chapters_view_header.dart", "Dart", 0, 0, 1, 0, 0, 0, 1
"/Users/carltonaikins/Desktop/Home/Programming/projects/elisha/lib/src/ui/views/church_view/church_view.dart", "Dart", 0, 0, 1, 0, 0, 0, 1
"/Users/carltonaikins/Desktop/Home/Programming/projects/elisha/lib/src/ui/views/church_view/components/church_view_header.dart", "Dart", 0, 0, 1, 0, 0, 0, 1
"/Users/carltonaikins/Desktop/Home/Programming/projects/elisha/lib/src/ui/views/daily_devotional_view/components/daily_devotional_view_header.dart", "Dart", 0, 0, 1, 0, 0, 0, 1
"/Users/carltonaikins/Desktop/Home/Programming/projects/elisha/lib/src/ui/views/daily_readings_view/components/daily_readings_view_header.dart", "Dart", 0, 0, 1, 0, 0, 0, 1
"/Users/carltonaikins/Desktop/Home/Programming/projects/elisha/lib/src/ui/views/daily_readings_view/daily_readings_view.dart", "Dart", 0, 0, -4, 0, 0, 0, -4
"/Users/carltonaikins/Desktop/Home/Programming/projects/elisha/lib/src/ui/views/favorite_verses_view/components/favorite_verses_view_header.dart", "Dart", 0, 0, -1, 0, 0, 0, -1
"/Users/carltonaikins/Desktop/Home/Programming/projects/elisha/lib/src/ui/views/favorite_verses_view/favorite_verses_view.dart", "Dart", 0, 0, -4, 0, 0, 0, -4
"/Users/carltonaikins/Desktop/Home/Programming/projects/elisha/lib/src/ui/views/home_view/home_view.dart", "Dart", 0, 0, -4, 0, 0, 0, -4
"/Users/carltonaikins/Desktop/Home/Programming/projects/elisha/lib/src/ui/views/introduction_view/components/birth_date_input.dart", "Dart", 0, 0, 5, 0, 0, 0, 5
"/Users/carltonaikins/Desktop/Home/Programming/projects/elisha/lib/src/ui/views/introduction_view/components/first_name_input.dart", "Dart", 0, 0, -3, 0, 0, -1, -4
"/Users/carltonaikins/Desktop/Home/Programming/projects/elisha/lib/src/ui/views/introduction_view/components/last_name_input.dart", "Dart", 0, 0, 1, 0, 0, 0, 1
"/Users/carltonaikins/Desktop/Home/Programming/projects/elisha/lib/src/ui/views/login_wrapper.dart", "Dart", 0, 0, -2, 0, 0, 0, -2
"/Users/carltonaikins/Desktop/Home/Programming/projects/elisha/lib/src/ui/views/profile_view/components/about_card.dart", "Dart", 0, 0, 1, 0, 0, 0, 1
"/Users/carltonaikins/Desktop/Home/Programming/projects/elisha/lib/src/ui/views/profile_view/components/bookmarks_card.dart", "Dart", 0, 0, 1, 0, 0, 0, 1
"/Users/carltonaikins/Desktop/Home/Programming/projects/elisha/lib/src/ui/views/profile_view/components/favorite_verses_card.dart", "Dart", 0, 0, 1, 0, 0, 0, 1
"/Users/carltonaikins/Desktop/Home/Programming/projects/elisha/lib/src/ui/views/profile_view/components/privacy_policy_card.dart", "Dart", 0, 0, 1, 0, 0, 0, 1
"/Users/carltonaikins/Desktop/Home/Programming/projects/elisha/lib/src/ui/views/profile_view/components/settings_card.dart", "Dart", 0, 0, 1, 0, 0, 0, 1
"/Users/carltonaikins/Desktop/Home/Programming/projects/elisha/lib/src/ui/views/profile_view/profile_view.dart", "Dart", 0, 0, 1, 0, 0, 0, 1
"/Users/carltonaikins/Desktop/Home/Programming/projects/elisha/lib/src/ui/views/settings_view/components/settings_view_header.dart", "Dart", 0, 0, 1, 0, 0, 0, 1
"/Users/carltonaikins/Desktop/Home/Programming/projects/elisha/lib/src/ui/views/settings_view/settings_view.dart", "Dart", 0, 0, 1, 0, 0, 0, 1
"/Users/carltonaikins/Desktop/Home/Programming/projects/elisha/lib/src/ui/views/sunday_mass_view/components/sunday_mass_view_header.dart", "Dart", 0, 0, 1, 0, 0, 0, 1
"/Users/carltonaikins/Desktop/Home/Programming/projects/elisha/lib/src/ui/views/sunday_mass_view/sunday_mass_view.dart", "Dart", 0, 0, -6, 0, 0, 0, -6
"/Users/carltonaikins/Desktop/Home/Programming/projects/elisha/lib/src/ui/views/verse_of_the_day_view/verse_of_the_day_view.dart", "Dart", 0, 0, -8, 0, 0, 0, -8
"/Users/carltonaikins/Desktop/Home/Programming/projects/elisha/pubspec.yaml", "YAML", 0, 0, 0, -1, 0, 0, -1
"Total", "-", 175, 1, 34, -1, -19, 22, 212